222222222222222
211100011111112
200000001111002
211000000001112
222000022333332
200001122111112
200011122220002
200011000000002
200011000000002
200000000333332
244444000000002
244444000444442
200000000000002
200000000000002
222222222222222