00000000000000000000
00111111111111111110
00155525515595595540
00111111111111111110
00000000151000000000
00000000151111100000
01310000151559120000
01510000151111100000
01510000151000000000
01511111181111111000
01955595515595591000
01111111111111151000
00000000151000191000
00001111151000151110
00001925551000159520
00001111111000111110
00000000000000000000