01010101010101010101
10000003000030000000
00000003333330000001
10000000000000000000
00000000000000000001
10000000000000000000
00000000000000000001
10000000000000000000
00000003333330000001
10000003000030000000
01010101010101010101