2222222222
2111000112
2000000012
2110000002
2000000002
2000011002
2000111002
2000110002
2000110002
2222222222